1111111111111111111111111111111111
1E100000000000000C000000A010000001
101001010010000010100100001A010101
1010010010101010001001000110010101
100000P000000000000000000C10000001
1111111111111111111111111111111111