1111111111111111111111111111111111
1E100000000000000C000000A000000001
10100101001000001010010000A0010101
1010010010101010001001000100010101
100000P000000000000000000C00000001
1111111111111111111111111111111111




