1111111111111111111111111111111111
1E0100000000000C10000C00000A000001
1010010100100000000001000000010001
1010010010101010000001000000011001
1P0000000C00C00010000A0000000000C1
1111111111111111111111111111111111