



1111111111111111111111111111111111
1E100000000000000C0000000000000001
1010010100100000101001000000010101
1010010010101010001001000100010101
100000P000000000000000000C00000001
1111111111111111111111111111111111




