1111111111111111111111111111111111
1E0100000000000C00000C00000A000001
1010010100100000101001000000010001
1010010010101010001001000000011001
1P0000000C00C00000000A0000000000C1
1111111111111111111111111111111111